11111111
10P00C01
1C0E0C01
11111111
