11111111111
1PC10C10C11
1C0EC000C01
10C0C01C101
11111111111
