11111111111
1PC10C11C11
1C0EC001C11
10C0C01C101
11111111111