11111111
1P101C01
110E0C01
11111111