11111111
1P000C11
100E0101
11111111
