11111111
1P001C01
110E1C01
11111111